Key  KEYWORD1
getKeyval	KEYWORD2
setKeyval	KEYWORD2
getState	KEYWORD2
isChanged	KEYWORD2
setChanged	KEYWORD2
setValue	KEYWORD2
setHoldTimer	KEYWORD2

KeypadListener	KEYWORD1
keyStateChanged	KEYWORD2

Keypad 	KEYWORD1
setPeriod	KEYWORD2
getPeriod	KEYWORD2
setHoldTime	KEYWORD2
getHoldTime	KEYWORD2
init		KEYWORD2
getPressed	KEYWORD2
isPressed	KEYWORD2
getState	KEYWORD2
get		KEYWORD2
